222222222222222222222222222222
233333333333333233333333333330
233233333233333233332222223332
233233333233333232333323322232
233233333222222233323323323332
222222223232323333323333322222
233333333332323322222223333332
233222222233332223333333222222
233333333233322222222333333332
222222223233323333332333332332
233333323233323333332332332332
232223323233223332222222332232
233323323233333333333332332332
232223323233222332222322232332
233323333333333333333333333332
212222222222222222222222222222
